13
/-----------\
|***********|
|***********|
|***********|
|***********|
|***********|
|***********|
|***********|
|***********|
|***********|
|***********|
|***********|
\-----------/
