25
/------------------------\
|*******  **  *  **  ****|
|****    ***  *   **    *|
|**     ***   **   *   **|
|*      ****   *   **    |
|***      **   *        *|
|**      ***  ***      **|
|***      *** **   **   *|
|**        *       *    *|
|*    ***      * *       |
|*    ***     ****     **|
|*                       |
|**  ** *          **   *|
|*   ****         ***    |
|**  ***        ****     |
|*****            ***    |
|* **              *     |
|*         *          ***|
|*        **           **|
|*    *****       *******|
|********     ***********|
|*****          *****   *|
|******        ***  ***  |
|** ***         ****  *  |
\------------------------/
