9
/--------\
|********|
|********|
|********|
|********|
|********|
|********|
|********|
\--------/
