25
*************************
*******  **  *  **  *****
****    ***  *   **    **
**     ***   **   *   ***
*      ****   *   **    *
***      **   *        **
**      ***  ***      ***
***      *** **   **   **
**        *       *    **
*    ***      * *       *
*    ***     ****     ***
*                       *
**  ** *          **   **
*   ****         ***    *
**  ***        ****     *
*****            ***    *
* **              *     *
*         *          ****
*        **           ***
*    *****       ********
********     ************
*****          *****   **
******        ***  ***  *
** ***         ****  *  *
*************************