13
/------------\
|* * ********|
|* * ********|
|* * ********|
|* * ********|
|* * ********|
|* * ********|
|* * ********|
|* * ********|
|* * ********|
|* * ********|
|* * ********|
\------------/
